ssssssss
s000000s
ss01110s
ss01s10s
ss01s10s
ss01110s
ss0000ss
ssssssss
